 XXXXXXXXXXXXXXXXXXXXXXXXXXXXXXXXXXXXXXXXXXXXXXXXXX
  X  X         X       X         X             X X
X X XXX XXXXXXX X XXXXX X XXXXX XXX XXX XXXXXXX X X
X X   X X   X   X X X   X X     X   X X   X   X X X
X XXX X XXX X XXX X X XXX X XXXXX XXX XXX XXX X X X
X   X   X   X       X   X X   X   X     X   X     X
XXX X XXX XXXXXXXXXXXXX X XXX X XXX X XXXXX XXXXXXX
X   X     X         X   X X   X X X X     X       X
X XXXXXXXXX XXXXXXX X XXX X X X X X XXX XXXXXXXXX X
X       X   X     X X     X X X X     X X       X X
XXXXXXX X XXXXX XXX XXXXXXX XXX X XXXXX X XXXXX X X
X     X   X   X   X       X   X X X   X X   X X X X
XXX X XXXXX X XXX XXXXXXX XXX X XXX X X XXX X X X X
X   X       X         X X X   X   X X   X   X X X X
X XXXXXXXXXXXXXXXXXXX X X X XXXXX X X XXX XXX X X X
X   X         X   X     X X         X X   X   X   X
XXX X XXXXXXX X X XXXXXXX X XXXXXXXXX X XXXXX XXX X
X   X   X X   X X X   X   X X       X X     X   X X
X XXXXX X X XXX X X X X XXXXX XXXXX XXXXXXX X XXX X
X         X     X   X         X             X     D
XXXXXXXXXXXXXXXXXXXXXXXXXXXXXXXXXXXXXXXXXXXXXXXXXXX

