 ####################################################################################################
    # #           #           #           #       #           #   #                                 #
### # # ######### # # ####### ######### # # # ##### ##### ##### # # ########### ########### #########
#   #     #   #   # #   #   #         # # # #       #   #   #   #     #       #   #         #       #
# ### ##### # # ### ### # ########### ### # ######### # ### # ######### ##### ### # ######### ##### #
# #   #     # #       # #     #   #   #   # #         #     # #   #   # #   #   # #   #           # #
# # ### ##### # ####### # ### # # # ### ### # ### ########### # ### # # # # ### ##### # ########### #
# # #   #   # # #     # # # #   #     # #   #   # #     #       #   #   # #   #     #     #     #   #
# ### ##### # ### ### # # # ######### # # ##### ### ### # ####### ####### ######### ####### ### # # #
#   #     #       #   # # #   #     #   # #   #       #     #   # #     #               #   # # # # #
### ##### ######### ### # ### # ### ##### # ############### # # # # ### ############### # ### # # # #
# #   #   #     # # #   #     #   #         #   #         # # # #     #           #   #   #   #   # #
# ### # ### ### # # # ######### ############# # # ####### ### # ########### ##### # # ####### ##### #
# #   #     # # #     #         #       #   # # #       #     #           #   #   # #   #       #   #
# # ### ##### # # ##### ######### ##### # # # # ### ### ################# ##### ### ### # ####### ###
#   #     #   # # #       #       #     # #   #   #   #     #     #             #     # #           #
# ####### ### # ### ##### # # ####### ### ####### ##### ### ### # # ############# ##### # ###########
#       #     #     #   # # # #     #     #   #       #   #   # #   #   #       # # #   #   #       #
####### ##### ####### # ### ### ### # ##### # ####### ####### ### ### # # ##### # # # ####### ##### #
#     #     #   #     #   #     #   # #   # #   #   #       #   #   # #   #     #   #             # #
##### ##### ##### ####### ### ### ##### # # ### ### ####### # # ##### ##### ####### ############### #
#         #   #   #     #   #   # #     # #   #   # #     # # #           #     #       #           #
# ########### # ### ####### ### # # ##### ### ### # # # ### ################# # # ####### ###########
#   #       #   # #         #   # #   #     # #   # # # #               #   # # # #     #           #
# # # ##### ##### # ########### # ### # ##### # ### # # # ############# # # ### # # ### ########### #
# #   #     #     #       #   # #   # # #     # #     #   #   #     # # # #     # # #             # #
# ##### ### ##### ####### # # ### ### # # ##### # ######### # # ### # # # ##### # # ############# # #
#   # #   # #   #   #     # #     #   # #   #   # #     #   #   #   #     #   # # # #       #   #   #
### # ### # # # ### # ##### ####### ### ### # ##### ### # ####### ####### # # # # # # ##### # # #####
# #   #   #   #     # #   #           #     #       #   #     #   #   #   # # # # #     #   # #     #
# ### # ######### ### # # # ##################### ### ####### # ### # ##### # ### ####### ### ##### #
#     #     #   # #   # # #       #   #     #   # #   #     # # #   #     # #       #     #     #   #
# ######### # # # # ##### # ####### # # ### # # ### # # # ### # # ####### # ######### ##### ##### ###
#     #     # # # #     #   #       #   #     #     # # #   # # # # #     #   #     # #   # #   #   #
####### ##### # ####### ##### ############### ######### ### # # # # # ##### ### ### # # # # # # ### #
#       #     #       #     #     #         # #         # # # # #   #       #   #     # #   # #   # #
# ####### ######### ####### # ### # ####### ### ######### # # # ### ######### ####### # ##### ### # #
#             #   #       # # #   # #   #   #             #   #   #   # #   #   #   # #   #   #     #
############### # ### ##### ### # # # # # ### ################# # ### # # # ### # # # ### # ### #####
#               #     #   #   # # # # # #     #               # #   #   # #   #   # #   # # #   #   #
# ######### ######### # # ### # ### # ##### ### ############# ##### # ### ### ##### # ### # ##### # #
# #   #     #   #     # #     #       #   # #   #           # #   # # #   #         # #   #     # # #
# # # ####### # ####### ####### ####### # ### ####### ####### # # # # # ############# # ####### # # #
# # #   #   # #     #   #     #     #   #     #       #       # #   # # #         #   #   #     # # #
# # ### # # # ##### # ### # # ####### ########### ### # ####### ##### # # ####### ####### # ##### # #
# #   #   # # # #   #   # # #         #     #     #   # #             # #       #         #     # # #
# ### ##### # # # ##### ### ########### ### # # ##### # ####### ####### ##### ######### ##### # # # #
#   # # #   # # #     # #   #   #     # #   # #     # #       #       #     # #       # #   # #   # #
# # # # # ### # ### ### # ### # # ### # ##### ##### # ####### ############# # # ##### ### # ####### #
# # #   #   #   #   #   # #   #   #   #   #   #   # #       #             #   # #         #         #
# ##### ### # ### ### ### # ####### ### # # ### # # ##### ############### ##### ############# ##### #
#       #   # #   #   #         #   #   # #   # # # #     #     #       #       #     #   #   #   # #
######### ### # ### ########### # ### ### ### # # # # ##### ### # ##### ####### # ### # ### ### # ###
#         #   #   #       #   # # #   #   #   # #   # #     # #     #   # #     #   # #     #   #   #
# ######### ##### ####### # # # # ### # ### ### ####### ##### ####### # # # ##### ### # ##### ##### #
#     #     # #   #     # # # # #   # #     #   #   #   #         #   #   # # #   #   # #     #     #
##### # ##### # # ### ### ### # ### ######### ### # # ######### ### # ##### # # ### # ### ##### ### #
#     #   #   # #     #   #   #   # #       #     #   #     #   #   # #   #   #   # # #   # #   # # #
# ### ### # # # ### ### ### ##### # # ##### ######### # ### # ### ##### # # ##### # # # ### # ### # #
# #     #   # #   # #   #     #   # # #   #         #   #     #   #     #   #     # # # #   # #   # #
# ##### ##### ### # # ### ### # ### # # # ######### ##### ##### # # ######### ##### # # ### # ### # #
#   # # #     # # # # #     #   #   # # # #       # #   # #     # #         # #   # # # #   #   #   #
# # # # # ##### # ### ########### ### ### # ##### # # # ### # ########### ### # ### ### # ##### # ###
# # #   #   #   #   # #           #       # #   #   # # #   # #           #   #   #       #     #   #
# # ####### ### ### # # ######### # ####### # # ### # # # ### # ########### ##### ######### ####### #
# #       #     #   # #         # # #     #   # #   # # #   # # #       #   #       #     # #   #   #
##### # ### ##### # # # ####### ### # ### ##### ##### # # # ### # ##### # ##### ##### ### # # # #####
#   # #     #     # # #     #   #   #   #     #   #   # # #     # #   #   #     #     #   #   #     #
# # ######### ##### # ####### ### ##### ##### ### # ### # ####### # # ####### ### ##### ####### ### #
# #           #     # #       #       #   #     # # #   #   #       #         #   #   # #     #   # #
# ############# ##### # ####### ####### # ##### # # # ##### # ################# ##### # # ### ##### #
# #   #   #   # #     # #   #     #   # #   # # #   #     # # # #               #     #   # #     # #
# # # # # ### # # ##### # # # ##### # ##### # # ######### # # # # ############### ######### ##### # #
#   #   #   #   #   #     #   #     #       #             # # # #         #     #           #   #   #
# ######### ####### # ######### ########################### # # ######### # ### ######### # # ##### #
#   #       #     # #   #     # #             #     #   #   #   #         #   # #       # #   #   # #
##### ####### # ### ### ### # # # ########### # ### # # # ### ### ####### ### # # ##### # ##### # # #
#     #   #   #   #   #   # # # # #   #       # #   # # #   # #   #     #   # # # # #   # #     # # #
# ##### # # ##### ### ### # ### # # # # ####### # ### # ##### # ### ### ##### # # # # ### # ##### # #
#       #   #       # #     #   # # # #         #   # # #     #   # #   #   # # #   # #         # # #
# ########### ####### ##### # ### # # ############# # # # ##### # # # ### # # # ### # ########### # #
# #           #   #   #   # #     # # #             # #   #   # # # # #   #   #     #       #     # #
# # ####### ### # # ### # ######### # # ########### # ##### # ### # # # ################# # # ##### #
# #   #     #   # # #   #     #     #   #     #     #   #   #     # #   #               # # #     # #
# ### ####### ### # ### ##### # ######### # # # ##### ### ######### ##### ############# ### ### # # #
#   #       # # #   #   #   #   #         # # # #     #   #   #     #   #       #     #   #   # #   #
### ####### # # ##### ### ####### ####### # ### # ##### # # # # ##### # ####### # ### ### # # ##### #
# #   # #   # #       #   #       #     # #     # #     # # #       # #         #   # #   # #     # #
# ### # # # # # ####### ### ##### # ### # ####### # ####### ######### ########### # ### ######### # #
#   #   # # # #     #       #   # #   # # #       # #       #       #         #   #               # #
# ### ### # # ##### ######### # ##### # ### ####### # ####### ##### ### ##### ##################### #
#     #   # #     #   #       # #     # #   #     #     #   # #   #   #     #   #   #         #     #
# ##### ######### ### # ####### # ##### # ##### ######### # # # # ### ### ##### # # # ##### # ##### #
# #     #       #   #   #     #   #   #         #         # #   # # #   # #   #   #   #   # #     # #
# # ### # ##### ### ### # ####### # # ######### # ######### # ### # ### ### # ### ##### # ####### # #
# # #   # #     # #   #   #     # # #     # #   # #         #   # #         #   #   #   #   #     # #
### ##### # ### # ### ##### ### ### ##### # # ### ##### ####### # ############# # ### ##### # ##### #
#   #   # # #       #   #   # #   #   #   #     #     # #       #       # #   # # #   #   # # #   # #
# ### # # # ########### # ### ### ### # ############# # ############### # # # # ### ### ### # # ### #
#     #   #               #           #               #                 #   #       #         #     D
#####################################################################################################